Aconia Minor	Aconia
Aélis	Aels	Aelis
Angharad	Angarade	Angharade
L’Ankou	L'Ankou
Anna de Tintagel	Anna
Anton
Ao Si Ka
Arthur Pendragon	Athur	Arhur	ARHUR	Arthur	Arturus	Roi Arthur	Le Roi Arthur	ARTHUR
Attila
Azénor	Azenor
Aziliz	Azilis
Belt
Berlewen
Père Blaise	Blaise	PERE BLAISE	ère Blaise
Bohort	ohort
Le père de Bohort	Bohort Père
Boniface	Évêque de Germanie
Breccan
Le roi burgonde	ROI BURGONDE	BURGONDE	Roi Burgonde
Buzit
Caius Camillus	Caius	CAIUS	Caïus
Calogrenant	Calegrenant
Publius Servius Capito	Servius
Cæsar Imperator	César
Cryda de Tintagel	Cryda	Dame Cryda
Dagonet
La Dame des Bois	Dame des Bois	Dame des bois
La Dame du Feu	Dame du Feu
La Dame du Lac	Dame du Lac	Viviane	La fée Viviane	La dame du Lac	La dame du lac	ame du Lac	DdLac	DdL	DDL	LA DAME DU LAC
La Dame des Pierres	Dame des Pierres
La Dame de la Sauvegarde	Dame de la Sauvegarde
Demetra	Démétra	Démetra	DEMETRA
Publius Desticius	Desticius
Drusilla
Le duc d’Aquitaine	Duc d’Aquitaine	Duc
La duchesse d’Aquitaine	Duchesse d’Aquitaine	Duchesse
Edern
Elias de Kelliwic’h	Elias	ÉLIAS	ELIAS
Evaine
Lucius Falerius	Falerius	Falérius
Ferghus	FERRGHUS
Fearmac	FERBACH
Ferme-Ta-Gueule
Mamercus Flaccus Calvo	Flaccus
Galessin
La Garde Royale
Gauvain
Titus Nipius Glaucia	Glaucia
Goustan
Grüdü	Grudu
Guenièvre	GUENIEVRE	Guenievre	Gueniève
Guethenoc	Guéthenoc
Hagop d’Arménie	Agothe d'Arménie
Herveig
Hervé de Rinel	Hervé
Hoël d’Armorique	Hoël	Hoel
L’interprète burgonde	Interprète	L'interprète
Vibius Iuventius Bestia	Iuventius	Luventius
Jacca
Julia
Le jurisconsulte	Le Jurisconsulte
Kadoc
Karadoc	Karaodc
Kay
Keu
Ketchatar
Lan
Lancelot du Lac	Lancelot	LANCELOT	Lanelot
Léodagan	Leodagan	Léogadan	LEODAGAN
Licinia
Lionel de Gaunes	Lionel
Loth d’Orcanie	Loth	Roi Loth	LOTH
Madenn
Le maître d’armes	LE MAITRE D’ARMES	LE MAITRE D'ARMES	Le Maître d’Armes	Maître d’Armes	Maître d'armes	Maitre d’arme	Maitre d'armes	Maître d’arme	Maître	MAÎTRE D’ARMES	LE MAÎTRE D'ARME	Le maître d’arme	Le Maître d’arme	d’arme	d'armes
Appius Manilius	Manilius	Manillius
Manius Macrinus Firmus	Macrinus
Le chef maure
Le jeune Maure
Méléagant
Merlin
Mevanwi	Dame Mevanwi	Mewvnwi	Mewanvi
La fée mère
La fée Morgane	Morgane	La Fée Morgane
Narsès	Narses
Nathair
Nessa
Caius Papinius	Papinius
Le Pêcheur
Perceval de Galles	Perceval	PERCEVAL	ERCEVAL
Vibius Pisentius Petrus	Pisentius
Aulus Milonius Procyon	Procyon
Marcus Oranius Lurco	Lurco
Prisca	voyante
Le Répurgateur	Répurgateur	Le répurgateur
Robyn	Le justicier
Roparzh	Ropharz
Lucius Silius Sallustius	Sallustius
Séfriane d’Aquitaine	Séfriane
Séli	Dame Séli	Dame Seli	DAME SÉLI	SELI	Sélie	Seli
Spurius Cordius Frontinius	Cordius	Frontinius
Sven
Le tavernier	Tarvernier	Le Tavernier	LE Tavernier	tavernier	TAVERNIER	Tavernier	tarvernier
Tegeirian
Le tricheur
Torri	L’intendante
Tumet
Urgan
Uther Pendragon	Uther
Venec	Vénec
Verinus	Vérinus
Le chef viking	Chef Viking
Ygerne de Tintagel	Ygerne	Dame Ygerne
Yvain	Yavain
