alcoolo	alcoolo	NC	ivrogne
baba	baba	NC	postérieur
baguenauder	baguenauder	V	danser
balèze	balèze	ADJ	fort
baloche	baloche	NC	bal
baloches	baloche	NC	testicules
barbaque	barbaque	NC	viande
barda	barda	NC	affaires
barouf	barouf	NC	bruit
basounettes	basounette	NC	base
batakouèques	batakouèque	NC	cérémonie
bécoter	bécoter	V	embrasser
bécotez	bécoter	V	embrasser
bectance	bectance	NC	nourriture
becqueter	becqueter	V	manger
bibi	bibib	NC	soi-même
bide	bide	NC	ventre
bille	bille	NC	personne incompétente
biquette	biquette	NC	femme
binez	binez	V	se tracasser
biter	biter	V	comprendre
bled	bled	NC	village
blondinet	blondinet	NC	jeune homme blond
bobonne	bobonne	NC	femme au foyer
boniche	boniche	NC	servante
bordel	bordel	NC	désordre
boucaque	boucaque	NC	Arabe
boucan	boucan	NC	bruit
boucane	boucane	NC	puanteur
bouclard	bouclard	NC	établissement
bouibouis	bouibouis	NC	débit de boissons
boulotter	boulotter	V	manger
bourre	bourre	NC	en retard
bourrer	bourrer	V	embêter
bourge	bourge	NC	bourgeois
bourrin	bourrin	NC	cheval
bourriner	bourriner	V	aller en force
bouseux	bouseux	NC	paysan
branquignol	branquignol	ADJ	incompétent
bricheton	bricheton	NC	pain
bronx	bronx	NC	désordre
broque	broque	NC	rien
bûcher	bûcher	V	travailler
buté	buter	V	tuer
buter	buter	V	tuer
cacarder	cacarder	V	répéter
cache-nez	cache-nez	NC	vin
cagauds	cagauds	NC	homme qui manque d’intelligence
cagaudes	cagaude	NC	femme qui manque d’intelligence
cagoles	cagole	NC	femme
cahute	cahute	NC	maison
cake	cake	NC	histoire
caquer	caquer	V	avoir peur
caisse	caisse	NC	pet
canaillou	canaillou	NC	appellation ironique
cancanez	cancaner	V	jaser
carrer	carrer	V	être indifférent
casquer	casquer	V	payer
casse-dalle	casse-dalle	NC	sandwich
casse-pattes	casse-pattes	NC	alcool fort
casse-pipe  casse-pipe  NC   combat
chambraient	chambrer	V	se moquer
charcu	charcutaille	NC	charcuterie
charcute	charcuter	V	blesser
chelous	chelou	ADJ	louche
chicot	chicot	NC	dent
chicots	chicot	NC	dents
chinetoque	chinetoque	NC	Asiatique
choper	choper	V	attraper
chopiez	choper	V	attraper
choucards	choucard	ADJ	beau
chougner	chougner	V	se plaindre
choure	choure	NC	vol
clacos	clacos	NC	fromage
clicheton	clicheton	NC	cliché
cochonaille	cochonaille	NC	charcuterie
cocolé	cocoler	V	folâtrer
colombes	colombe	NC	personne naïve
comac	comac	ADJ	remarquable
contrefous	contrefoutre	V	s’en moquer
coupette	coupette	NC	verre
cradingue	cradingue	ADJ	sale
craintu	craintu	ADJ	dangereux
créchez	crécher	V	dormir
cureton	cureton	NC	ecclésiastique
dalle	dalle	NC	rien
danse	danse	NC	correction
débaroulé	débarouler	V	arriver
débarouler	débarouler	V	arriver
débaroulez	débarouler	V	arriver
débilos	débilos	NC	personne qui manque d’intelligence
décarade	décarade	NC	fuite
décarrer	décarrer	V	partir
décarrez	décarrer	V	partir
défouraillez	défourailler	V	dégainer
dégobiller	dégobiller	V	vomir
dégringoler	dégringoler	V	tomber
dégueu	dégueu	ADJ	répugnant
dégueues	dégueu	ADJ	répugnant
dégueus	dégueu	NC	personnes sales
démerdez	démerder	V	se débrouiller
démerdiez	démerder	V	se débrouiller
derche	derche	NC	postérieur
dérouillés	dérouiller	V	battre
deux	deux	NC	testicules
dézingué	dézinguer	V	tuer
discutaillé	discutailler	V	discuter
discutailler	discutailler	V	discuter
discutaillez	discutailler	V	discuter
duraille	duraille	NC	pénible
embobinage	embobinage	NC	escroquerie
emboucaner	emboucaner	V	empuantir
engueulades	engueulade	NC	querelle
entubage	entubage	NC	escroquerie
estancot	estancot	NC	débit de boissons
farcir	farcir	V	supporter
farcirais	farcir	V	supporter
farcirez	farcir	V	supporter
femmelettes	femmelette	NC	homme faible
filoche filoche NC   au combat
filoche filocher    V   partir
fion	fion	NC	postérieur
fions	fion	NC	insulte
fiotte	fiotte	NC	homme peu viril
foirer	foirer	V	échouer
fourbi	fourbi	NC	chose
foutage	foutage	NC	raillerie
foutre  foutre  V   faire
frichti	frichti	NC	repas
frite	frite	NC	fête
frité	friter	V	se battre
fritée	friter	V	se battre
friter	friter	V	se battre
froc    froc    NC   pantalon
frogome	frogome	NC	fromage
galérer	galérer	V	rencontrer des difficultés
gameler	gameler	V	manger
glanderie	glanderie	NC	sottise
glandiez	glander	V	ne rien faire
glandouillos	glandouillos	NC	bon à rien
glaviots	glaviot	NC	crachat
godet	godet	NC	verre
goinfrant	goinfrer	V	manger
goinfré	goinfrer	V	manger
gonfler	gonfler	V	ennuyer
gonzesse	gonzesse	NC	femme
gonzesses	gonzesse	NC	femme
gourdasse	gourdasse	NC	femme
gourdasses	gourdasse	NC	femme
gouré	gourer	V	se tromper
grouillot	grouillot	NC	serviteur
guignolo	guignolo	NC	bon à rien
guitare	guitare	NC	jambe
guitares	guitare	NC	jambe
gugus	gugus	NC	bon à rien
haricot	haricot	NC	tête
jaja	jaja	NC	vin
jambons	jambon	NC	jambe
jetons	jeton	NC	avoir peur
joisses	joisse	ADJ	content
larbins	larbin	NC	serviteur
larbinos	larbinos	NC	serviteur
lopette	lopette	NC	homme peu viril
louffer	louffer	V	péter
loufiats	loufiat	NC	serviteur
magnez	magner	V	se dépêcher
maquillent	maquiller	V	dissimuler
maquillez	maquiller	V	dissimuler
marave	marave	NC	bagarre
maravé	maraver	V	se battre
maraver	maraver	V	se battre
matignons	matignon	NC	messager
mectons	mecton	NC	homme
merdaillon	merdaillon	NC	bon à rien
merdier	merdier	NC	mauvaise situation
miches	miche	NC	postérieur
micheton	micheton	NC	homme
michetonner	michetonner	V	arnaquer
miquetter	miquetter	V	avoir peur
miquettes	miquette	NC	peur
mollo	mollo	ADV	modérément
mômes	môme	NC	enfant
môssieu	môssieu	NC	monsieur
mouille	mouille	NC	figure
mouilles	mouille	NC	figure
murge	murge	NC	saoûlerie
nénette	nénette	NC	tête
nichons	nichon	NC	seins
noix	noix	NC	testicules
nouba	nouba	NC	fête
page	page	NC	lit
pageot	pageot	NC	lit
perm	perm	NC	permission
perms	perm	NC	permission
pâlotte	pâlot	ADJ	pâle
panne	panner	V	comprendre
papatte	papatte	NC	patte
patapouffe	patapouffe	NC	insulte
paumer	paumer	V	se perdre
paumera	paumer	V	se perdre
paumez	paumer	V	se perdre
pécore	pécore	NC	paysan
pécores	pécore	NC	paysan
pégu	pégu	NC	paysan
pégus	pégu	NC	paysan
peigne-zizis	peigne-zizis	NC	personne incompétente
péquenot	péquenot	NC	paysan
péquenots	péquenot	NC	paysan
petitou	petitou	NC	petit
pèze	pèze	NC	argent
piaule	piaule	NC	chambre
picrate	picrate	NC	vin
pif	pif	NC	nez
pif	pif	NC	vin
pige	pige	NC	année
piges	pige	NC	année
piger	piger	V	comprendre
pignouf	pignouf	NC	imbécile
pignoufs	pignouf	NC	imbécile
pinés	piner	V	se faire avoir
pintent	pinter	V	boire
pognon	pognon	NC	argent
poireauter	poireauter	V	attendre
poireautez	poireauter	V	attendre
poquer	poquer	V	puer
pompes	pompe	NC	chaussure
poucrave	poucrave	ADJ	pourri
pouillé	pouiller	V	se disputer
pourave	pourave	ADJ	pourri
quéquette	quéquette	NC	pénis
quicher	quicher	V	insulter
quique	quique	NC	pénis
quiquis	quiqui	NC	pénis
quiquette	quiquette	NC	pénis
rab	rab	NC	surplus
rable	rable	NC	corps
radiner	radiner	V	venir
radis	radis	NC	argent
rafler	rafler	V	empocher
raisins	raisin	NC	testicules
rapiat	rapiat	NC	avare
rapiats	rapiat	NC	avare
rata	rata	NC	nourriture
ratichon	ratichon	NC	ecclésiastique
ric-rac	ric-rac	ADJ	de peu
rince-gosiers	rince-gosier	NC	cafetier
rond    rond    NC   argent
ronds   rond    NC   argent
ronquer	ronquer	V	dormir
rosières	rosière	NC	personne pudique
rougeot	rougeot	NC	vin
roupes	roupe	NC	testicules
roupilleraient	roupiller	V	dormir
saligaud	saligaud	NC	sale type
saloir  saloir  NC   tuerie
saquer  saquer  V   supporter
sauce	sauce	NC	saucisson
schlinguer	schlinguer	V	puer
singe	singe	NC	nourriture
slibard	slibard	NC	slip
slibards	slibard	NC	slip
suriner	suriner	V	tuer
tâche	tâche	NC	personne incompétente
tagazou	tagazou	NC	insulte
tantouze	tantouze	NC	insulte
tarlouze	tarlouze	NC	insulte
tarlouzes	tarlouze	NC	insulte
tartignolle	tartignolle	NC	de basse qualité
titou	titou	NC	petit
tortore tortore NC   nourriture
traczir	traczir	NC	peur
traîne-galoches	traîne-galoches	NC	bon à rien
traîne-la-grole	traîne-la-grole	NC	bon à rien
traîne-patins	traîne-patins	NC	bon à rien
traîne-savates	traîne-savates	NC	bon à rien
traviole	traviole	ADV	travers
tristounet	tristounet	ADJ	triste
tronc	tronc	NC	corps
tronche	tronche	NC	tête
trou	trou	NC	prison
trouducs	trouduc	NC	bon à rien
tsoin-tsoin	tsoin-tsoin	ADJ	doux
tutut	tutut	NC	signal
vavache	vavache	NC	vache
visu	visu	NC	en vrai
zob	zob	NC	pénis
zonez	zoner	V	déambuler
